111111111111111111111111111111111111111111
1P000000000000E1000000000C0000000000C00001
111011101110110111101110111011101110110101
1C0000000C000001C0000000000C0000000C000001
101110111011100000111011101110111011101101
1C0000C0000000C1C000000C0000C000000C0000C1
101111011111110110111111011111011111110101
1C00000000000C01C0000000000C00000000000C01
111101110111110111011101110111011101110101
1C000000C0000001C0000C0000000C0000C0000001
111111111111111111111111111111111111111111
