

	1111111111111111
	10C0000000000001
	1011111000000C01
	10000C1001110001
	1011111001C11111
	1010P00011000001
	1C11110000010001
	10000C010C010E01
	1111111111111111
