11111
1P111
11101
1C0E1
11111
