11111
1P0C1
11101
1C1E1
11111
