111111
1P0001
101101
1C0E11
111111
