11111
1P0C1
1CE11
1C001
11111
