11111
1P0C1
11111
1C1E1
11111
