111111
1P0001
1000C1
1C00E1
111111
