1111111111111111111111111
1P000000000000E10000000C1
1110111011101101101110111
1C0000000C000001C00000001
1011101110111000011011101
1C0000C0000000C1C0000C001
1011110111111101101111011
1C00000000000C01C00000001
1111011101111101001101111
1C000000C0000001C00C00001
1111111111111111111111111
