111111
1P0C11
10C001
111011
1000E1
111111
